#############################
# Jailbreak
#############################

jailbreak_objective1	3 Gruppen Darwinianer werden hier gefangen gehalten. Sie sind die allerletzten, die anderen wurden an die Waffe verfüttert.
jailbreak_objective2	Wir haben nicht viel Zeit übrig. Du musst die gefangenen Darwinianer befreien. Wir benötigen mindestens 75 von Ihnen, um die Waffe ausschalten zu können.
jailbreak_objective3	Sie werden hinter diesen Laserzäunen gefangen gehalten. Du musst sie irgendwie ausschalten, um die Darwinianer zu befreien.
jailbreak_objective4	Sobald du sie befreit hast, musst du sie zu diesem Verbindungsportal bringen, dem einfachsten Weg zur Waffe. Ich versuche, die Roten aufzuhalten, während du das tust. Viel Glück!

jailbreak_objective5	Ameisen. Die wohl produktivste Form des Virus. Immer, wenn ich denke, dass wir sie ausgerottet haben, gibt es irgendwo wieder einen Ausbruch.
jailbreak_objective6	Langsam glaube ich, dass die Roten Darwinianer vorsätzlich Ameisennester ansiedeln, ich habe aber keine Ahnung wie.
jailbreak_objective7	Jedenfalls dürfen wir sie nicht über diesen Punkt hinaus lassen. Wenn sie es schaffen, gibt es vielleicht kein Darwinia mehr, das wir retten könnten. Du musst sie ausmerzen, bevor sie von hier verschwinden.

jailbreak_objective8	Die Roten haben die Grünen Darwinianer kurz nach der Gefangennahme entwaffnet. Der Code in dieser Datei sollte sie wieder bewaffnen.
jailbreak_objective9	Lade mit einem Ingenieur die Datei in mein System hoch und wir haben eine echte Chance.

jailbreak_intro_1	Ach du meine Güte, du bist hier! Ich brauche deine Hilfe. Das Schicksal von Darwinia steht auf dem Spiel.
jailbreak_intro_2	Die Roten Darwinianer haben eine Waffe erschaffen und sie verwenden Rohre wie diese in ganz Darwinia, um Grüne Darwinianer damit zu füttern.
jailbreak_intro_3	Ich weiß nicht genau wie, aber ich glaube, sie verwenden die Seelen der Darwinianer, um sie zu kalibrieren.
jailbreak_intro_4	Sie haben eine ganze Armee massiert und mehrere wichtige Punkte in ganz Darwinia erobert. Es passierte alles so schnell... die Grünen Darwinianer wurden komplett überrascht.
jailbreak_intro_5	Diese Waffe... Sie zielt genau auf das Seelenreservoir. Wenn sie abgefeuert wird, wird jede einzelne Seele im Reservoir korrumpiert. Jeder neue Darwinianer, der geboren wird, wird ein Roter.
jailbreak_intro_6	Wenn das passiert, hört das Darwinia, wie wir es kennen, auf zu existieren. Wir müssen sie aufhalten.

# New version
jailbreak_objective_1	Ameisenbefall ausrotten
jailbreak_objective_2	Befreie 75 Darwinianer
jailbreak_objective_3	Bewaffne 75 Darwinianer

jailbreak_trunkport_1	Oh, jemand hat dieses Verbindungsportal aktiviert...
jailbreak_trunkport_2	Oh nein! Ich dachte, die Viecher wären alle zerstört worden! Du musst es töten, schnell!
jailbreak_trunkport_3	Hier, nimm das hier. Es ist seit einiger Zeit außer Betrieb, sollte aber noch funktionieren.
jailbreak_trunkport_4	Denke daran, dass du die Darwinianer um jeden Preis verteidigen musst! Ohne Sie werden wir die Waffe niemals stoppen können!

jailbreak_armed_1	Gut, sehr gut. Die Darwinianer sind jetzt bewaffnet 
jailbreak_armed_2	Jetzt haben wir eine Chance, uns zur Waffe durchzukämpfen.

jailbreak_control_1	Dieses Gebäude sieht aus wie eine Kontrollstation für die Laserzäune. 
jailbreak_control_2	Wenn du die Darwinianer zerstörst, die darin arbeiten, schaltet sich der Zaun vielleicht ab.

jailbreak_switch_1	Dieses Gebäude ist anscheinen mit zwei Laserzäunen verbunden...
jailbreak_switch_2	Du musst die das Gebäude mit den Grünen Darwinianern erobern und die Zäune abschalten, um die Gefangenen zu befreien.
jailbreak_capture_1	Ok, da du jetzt diesen Schalter erobert hast, kannst du mit ihm die beiden Zäune ausschalten, die er kontrolliert.
jailbreak_capture_2	Klicke einfach auf das Gebäude, um die Zäune ein- und auszuschalten.

#############################
# Stronghold
#############################

stronghold_objective	Vernichte die Roten Darwinianer
stronghold_intro_1	Nach dem Ende des Großen Krieges haben sich die Darwinianer unglaublich schnell entwickelt.
stronghold_intro_2	Schon bald bauten sie sich selbst eine zweite Wiedergeburtsanlage, damit die Bevölkerung mit der Ausbreitung mithielt.
stronghold_intro_3	Leider haben die Roten das Gebiet überrannt und eine Armee aufgebaut, mit der sie die Waffe beschützen, während sie deren Abfeuern vorbereiten.
stronghold_intro_4	Unsere einzige Chance die Waffe zu deaktivieren, liegt in der Wiedereroberung dieses Gebiets.
stronghold_intro_5	Erobere mit den Darwinianern, die du aus dem Gefängnis befreit hast, die Brutpunkte auf den Inseln und baue eine Armee auf.
stronghold_intro_6	Du musst die Roten vollständig ausmerzen. Überleben zu viele von ihnen, können Sie das Gebiet zurückerobern und wir werden die Waffe nie aufhalten. Viel Glück.

stronghold_weapon_1	Das ist nicht gut, überhaupt nicht gut.
stronghold_weapon_2	Ich habe versucht herauszufinden, welchen Effekt die Waffe überhaupt hat, als mir auffiel, dass sie viel mit den Seelenvernichtern gemein hat...
stronghold_weapon_3	Sie wollen das Seelenreservoir nicht korrumpieren, sie wollen es zerstören! Du musst dich beeilen.

#############################
# Doomsday
#############################


doomsday_objective	Waffe ausschalten

doomsday_turret_1	Anscheinend haben die Roten Darwinianer selbst ein paar Türme gefunden...
doomsday_turret_2	Erobere sie in funktionsfähigem Zustand, denn sie könnten uns bei der Abwehr helfen, während du die Waffe deaktivierst.

doomsday_intro_1	Das ist es. Wir haben nicht viel Zeit, sie machen sich schon bereit, die Waffe abzufeuern.
doomsday_intro_2	Du musst die Kontrollpunkte erobern und lange genug halten, um sie zu deaktivieren.
doomsday_intro_3	Leider haben sie starke Verteidigungslinien aufgebaut, um uns daran zu hindern. Du musst auch die Zaunkontrollpunkte erobern.
doomsday_intro_4	Sobald die Roten herausfinden, dass du hier bist, werden sie sicherlich Verstärkungen schicken. Ich werde mit dem Rest der Darwinianer versuchen, sie aufzuhalten.
doomsday_intro_5	Ich brauche dir sicherlich nicht zu sagen, was hier auf dem Spiel steht. Viel Glück.

doomsday_trunkports_1	Die Roten sind durch meine Verteidigungslinien gebrochen! Sie werden jeden Moment durch die Verbindungsportale strömen!
doomsday_trunkports_2	Du musst um jeden Preis diese Kontrollpunkte halten!

#############################
# Outro
#############################

outro1	Du hast es geschafft! Ich muss zugeben, ich hätte nicht erwartet, dass die Waffe so explodieren würde. Die Darwinianer müssen sie überladen haben, statt sie einfach auszuschalten.
outro2	Wieder einmal hast du Darwinia gerettet. Ich kann dir nicht genug danken.
outro3	Dies ist vielleicht ein weiteres wichtiges Kapitel in der Geschichte der Darwinianer. Sie scheinen sich an alles zu erinnern und ich weiß, dass sie dankbar sind für deine Hilfe.
outro4	Ich glaube nicht, dass wir den Virus jemals wirklich loswerden. Und die heutigen Ereignisse zeigen, dass er so gefährlich wie eh und je ist.
outro5	Aber mit deiner Hilfe können wir Darwinia und seine Bewohner sicherlich beschützen.
outro6	Danke für alles.
